30010011101011001015
00011010101001011010
10100010000001000000
10100001110100011110
10001010010011001000
00111011111012101011
11100010010010101001
01110111000100111101
00000100011101000100
50101111111100010001
