30010001110100110001
01100101011110101101
00001100010011010011
11100001101000010400
00001110110411101012
11100100111010040000
10001100010001011110
11100001100101011001
00101110001101000111
10000000111000011011