30010110001011011000
01010000101010040010
01000110100010111011
00110011110110101002
10100100100010001111
00110110111010100101
10000010001000111101
01111011101111100001
00010000100010101000
11000110001000001101