30000100001000000006
01101501010101011101
00000114000001110000
11010000101010000111
00001110101110101100
01100100111010000001
00011101200001170111
11010100101110010100
05100010100001000100
00001000110100000000