30001000110011110001
01100010000100000100
00101100110111010111
01000001110101010112
01111101101101010100
00001100101100010001
10101110000001111111
10101000011100000000
00111011110001111011
10100000011100000010
